Script started on 2024-04-08 23:43:50-04:00
bash: alias: ls -latr: not found
bash-4.4$ ~/.bash_profile
bash: /mnt/scratch/SP24_CS131_Jyotika/gursimransp24/.bash_profile: No such file or directory
bash-4.4$ pwd][K
/mnt/scratch/SP24_CS131_Jyotika/gursimransp24
bash-4.4$ ls -la ~/.bash_profile
ls: cannot access '/mnt/scratch/SP24_CS131_Jyotika/gursimransp24/.bash_profile': No such file or directory
bash-4.4$ vi ~/.bash_profile
[?2004h[?1049h[22;0;0t[?1h=[?2004h[1;63r[?12h[?12l[27m[23m[29m[m[H[2J[?25l[63;1H"~/.bash_profile" [New File][2;1H[94m~                                                                                                   [3;1H~                                                                                                   [4;1H~                                                                                                   [5;1H~                                                                                                   [6;1H~                                                                                                   [7;1H~                                                                                                   [8;1H~                                                                                                   [9;1H~                                                                                                   [10;1H~                                                                                                   [11;1H~                                                                                                   [12;1H~                                                                                                   [13;1H~                                                                                                   [14;1H~                                                                                                   [15;1H~                                                                                                   [16;1H~                                                                                                   [17;1H~                                                                                                   [18;1H~                                                                                                   [19;1H~                                                                                                   [20;1H~                                                                                                   [21;1H~                                                                                                   [22;1H~                                                                                                   [23;1H~                                                                                                   [24;1H~                                                                                                   [25;1H~                                                                                                   [26;1H~                                                                                                   [27;1H~                                                                                                   [28;1H~                                                                                                   [29;1H~                                                                                                   [30;1H~                                                                                                   [31;1H~                                                                                                   [32;1H~                                                                                                   [33;1H~                                                                                                   [34;1H~                                                                                                   [35;1H~                                                                                                   [36;1H~                                                                                                   [37;1H~                                                                                                   [38;1H~                                                                                                   [39;1H~                                                                                                   [40;1H~                                                                                                   [41;1H~                                                                                                   [42;1H~                                                                                                   [43;1H~                                                                                                   [44;1H~                                                                                                   [45;1H~                                                                                                   [46;1H~                                                                                                   [47;1H~                                                                                                   [48;1H~                                                                                                   [49;1H~                                                                                                   [50;1H~                                                                                                   [51;1H~                                                                                                   [52;1H~                                                                                                   [53;1H~                                                                                                   [54;1H~                                                                                                   [55;1H~                                                                                                   [56;1H~                                                                                                   [57;1H~                                                                                                   [58;1H~                                                                                                   [59;1H~                                                                                                   [60;1H~                                                                                                   [61;1H~                                                                                                   [62;1H~                                                                                                   [1;1H[?25h[?25l[m[63;1H[1m-- INSERT --[m[63;13H[K[1;1H[?25h[?25lalias l='ls -ltr'[?25h[?25l[2;1H[K[2;1H[?25h[?25l[94m~                                                                                                   [1;18H[?25h[?25l[m[1;17H[K[1;17H[?25h[?25l[1;16H[K[1;16H[?25h[?25l[1;15H[K[1;15H[?25h[?25l[1;14H[K[1;14H[?25h[?25l[1;13H[K[1;13H[?25h[?25l[?25h[?25l[1;11H[K[1;11H[?25h[?25l[1;10H[K[1;10H[?25h[?25l[1;9H[K[1;9H[?25h[?25l[1;8H[K[1;8H[?25h[?25l[1;7H[K[1;7H[?25h[?25l[?25h[?25l[1;5H[K[1;5H[?25h[?25l[1;4H[K[1;4H[?25h[?25l[1;3H[K[1;3H[?25h[?25l[1;2H[K[1;2H[?25h[?25l[1;1H[K[1;1H[?25h[?25l:[?25h[?25lw[?25h[63;1H[K[1;2H[?25l[?25h:[?25l[63;1H[1m-- INSERT --[1;2H[?25h[?25l[mw[1;2H[K[1;1H[?25hw[?25l[1;1H[K[1;1H[?25h[63;1H[K[1;1H[?25l[?25h[?25l[63;1H:[?2004h[?25hwq
[?25l[?2004l".bash_profile" [New] 1L, 1C written


[?2004l[?1l>[?25h[?1049l[23;0;0tbash-4.4$ alias l='ls -ltr'
bash-4.4$ alias w='ls -l | wc -l'
bash-4.4$ source ~/.bash_profile
bash-4.4$ l
total 784
-rw-rw-r-- 1 gursimransp24 gursimransp24 222895 Feb 21 12:38  index.html
drwxrwxr-x 2 gursimransp24 gursimransp24   4096 Feb 21 12:58  mydir
-rw-rw-r-- 1 gursimransp24 gursimransp24 200279 Feb 21 22:50 'Global YouTube Statistics.csv'
drwxrwxr-x 2 gursimransp24 gursimransp24   4096 Feb 22 21:45  Worksheet2
-rw-rw-r-- 1 gursimransp24 gursimransp24    240 Feb 28 10:04  typescript
-rw-rw-r-- 1 gursimransp24 gursimransp24      0 Feb 28 11:15  Assignment1.txt
-rw-rw-r-- 1 gursimransp24 gursimransp24    686 Feb 28 13:06  users.lst
prw-rw-r-- 1 gursimransp24 gursimransp24      0 Mar 11 12:23  myPipe1
-rw-rw-r-- 1 gursimransp24 gursimransp24     13 Mar 11 12:24  mymyPipe1
-rw-rw-r-- 1 gursimransp24 gursimransp24  15113 Mar 20 13:35  years.txt
-rw-rw-r-- 1 gursimransp24 gursimransp24   4252 Mar 20 13:35  months.txt
-rw-rw-r-- 1 gursimransp24 gursimransp24  19365 Mar 20 13:35  year_month.txt
-rw-rw-r-- 1 gursimransp24 gursimransp24  27247 Mar 20 13:35  counts.txt
-rw-rw-r-- 1 gursimransp24 gursimransp24  27247 Mar 20 13:35  sorted_counts.txt
-rw-rw-r-- 1 gursimransp24 gursimransp24     78 Mar 20 13:35  top_3_combinations.txt
-rw-rw-r-- 1 gursimransp24 gursimransp24    318 Mar 20 13:55  Assignment2.txt
-rw-rw-r-- 1 gursimransp24 gursimransp24    318 Mar 20 13:57  file.txt
-rw-rw-r-- 1 gursimransp24 gursimransp24  17801 Mar 20 14:24  cmds.log
-rw-rw-r-- 1 gursimransp24 gursimransp24 200279 Mar 25 19:20 'Global YouTube Statistics.csv.1'
drwxrwxr-x 9 gursimransp24 gursimransp24   4096 Mar 25 19:21  cs131
-rw-rw-r-- 1 gursimransp24 gursimransp24    112 Apr  8 12:40  Scriptfilename
-rw-rw-r-- 1 gursimransp24 gursimransp24     48 Apr  8 12:41  Scriptfilename.sh
-rw-rw-r-- 1 gursimransp24 gursimransp24   8192 Apr  8 23:48  ws4.txt
bash-4.4$ w
24
bash-4.4$ mkdir -p Worksheet4/Subscribers[C[1P Worksheet4/Subscribers
[C[C[C[C[C[C[C[C[C[C[C[C[C[C[C[C[C[1P Worksheet4/Subscribers
[C[C[C[C[C[C[C[C[C[C[C[C[C[C[C[C[1PWorksheet4/Subscribers
[C[C[C[C[C[C[C[C[C[C[C[C[C[C[C
mkdir: cannot create directory ‘Worksheet4/Subscribers’: No such file or directory
bash-4.4$ mkdir -p Worksheet4/Subscribers
bash-4.4$ cat 'Global YouTube Statistics.csv'

bash-4.4$ 
bash-4.4$ 
bash-4.4$ 
bash-4.4$ 
bash-4.4$ 
bash-4.4$ 
bash-4.4$ grep "United States" YouTubers.csv | cut -d ',' -f 4 > Worksheet4/Subscribers/United_States
s.txt
 > Worksheet4/Subscribers/United_States.[1Ptxt Worksheet4/Subscribers/United_States.txt

| cut -d ',' -f 4 > Worksheet4/Subscribers/United_States.[1Ptxt| cut -d ',' -f 4 > Worksheet4/Subscribers/United_States.t[1Pxt| cut -d ',' -f 4 > Worksheet4/Subscribers/United_States.tx[1Pt | cut -d ',' -f 4 > Worksheet4/Subscribers/United_States.txt[K | cut -d ',' -f 4 > Worksheet4/Subscribers/United_States.txt 


'Global YouTube Statistics.csv' | cut -d ',' -f 4 > Worksheet4/Subscriibers/United_States.txt


bash-4.4$ grep "United States" 'Global YouTube Statistics.csv' | cut -d ',' -f 4 > Worksheet4/Subscriibers/United_States.txt[1P.txt[1P.txt[1P.txt[1P.txt[1P.txt[1P.txt[1P.txt[1P.txt[1P.txt[1P.txt[1P.txt[1P.txt[1P.txtI.txtn.txtd.txti.txta.txt
bash-4.4$ cat United_states.e[Ktxt
cat: United_states.txt: No such file or directory
bash-4.4$ vi United_states
[?2004h[?1049h[22;0;0t[?1h=[?2004h[1;63r[?12h[?12l[27m[23m[29m[m[H[2J[?25l[63;1H"United_states" [New File][2;1H[94m~                                                                                                   [3;1H~                                                                                                   [4;1H~                                                                                                   [5;1H~                                                                                                   [6;1H~                                                                                                   [7;1H~                                                                                                   [8;1H~                                                                                                   [9;1H~                                                                                                   [10;1H~                                                                                                   [11;1H~                                                                                                   [12;1H~                                                                                                   [13;1H~                                                                                                   [14;1H~                                                                                                   [15;1H~                                                                                                   [16;1H~                                                                                                   [17;1H~                                                                                                   [18;1H~                                                                                                   [19;1H~                                                                                                   [20;1H~                                                                                                   [21;1H~                                                                                                   [22;1H~                                                                                                   [23;1H~                                                                                                   [24;1H~                                                                                                   [25;1H~                                                                                                   [26;1H~                                                                                                   [27;1H~                                                                                                   [28;1H~                                                                                                   [29;1H~                                                                                                   [30;1H~                                                                                                   [31;1H~                                                                                                   [32;1H~                                                                                                   [33;1H~                                                                                                   [34;1H~                                                                                                   [35;1H~                                                                                                   [36;1H~                                                                                                   [37;1H~                                                                                                   [38;1H~                                                                                                   [39;1H~                                                                                                   [40;1H~                                                                                                   [41;1H~                                                                                                   [42;1H~                                                                                                   [43;1H~                                                                                                   [44;1H~                                                                                                   [45;1H~                                                                                                   [46;1H~                                                                                                   [47;1H~                                                                                                   [48;1H~                                                                                                   [49;1H~                                                                                                   [50;1H~                                                                                                   [51;1H~                                                                                                   [52;1H~                                                                                                   [53;1H~                                                                                                   [54;1H~                                                                                                   [55;1H~                                                                                                   [56;1H~                                                                                                   [57;1H~                                                                                                   [58;1H~                                                                                                   [59;1H~                                                                                                   [60;1H~                                                                                                   [61;1H~                                                                                                   [62;1H~                                                                                                   [1;1H[?25h[?25l[m[63;1H[K[63;1H:[?2004h[?25hwq
[?25l[?2004l"United_states" [New] 0L, 0C written


[?2004l[?1l>[?25h[?1049l[23;0;0tbash-4.4$ cat United_States.txt
cat: United_States.txt: No such file or directory
bash-4.4$ grep "United States" 'Global YouTube Statistics.csv' | cut -d ',' -f 3 > Worksheet4/Subscri
ibers/United_States.txt
bash-4.4$ grep "India" 'Global YouTube Statistics.csv' | cut -d ',' -f 3 > Worksheet4/Subscribers/Ind
dia.txt
bash-4.4$ 
bash-4.4$ cat Worksheet4/Subscribers/United_States.txt
170000000
166000000
162000000
98900000
96000000
75000000
68200000
59500000
59500000
56900000
56400000
52900000
52700000
52200000
47900000
46600000
44200000
42400000
42400000
40900000
39200000
38600000
38200000
38200000
38000000
37600000
36700000
36600000
36300000
35200000
35200000
34900000
33700000
33600000
32800000
32700000
31700000
31700000
31600000
31600000
31200000
30700000
30700000
30400000
30200000
30100000
29600000
29200000
28400000
28200000
27500000
27500000
27300000
27000000
26700000
26700000
26500000
26400000
26200000
26100000
25700000
25700000
25600000
25500000
25400000
25200000
25100000
24800000
24700000
24600000
24600000
24400000
24100000
24100000
24100000
24000000
23900000
23900000
23900000
23800000
23800000
23700000
23700000
23600000
23600000
23300000
23200000
23200000
23100000
23100000
22900000
22700000
22600000
22600000
22600000
22500000
22500000
22300000
22200000
22000000
22000000
21900000
21900000
21900000
21800000
21800000
21600000
21500000
21300000
21300000
21300000
21100000
21000000
21000000
21000000
20900000
20900000
20900000
20700000
20700000
20700000
20500000
20400000
20200000
20100000
20100000
20100000
20100000
20100000
20100000
20100000
20000000
20000000
19800000
19800000
19700000
19700000
19600000
19600000
19600000
19600000
19200000
19100000
19100000
18800000
18800000
18600000
18400000
18400000
18300000
18300000
18100000
18100000
18000000
18000000
18000000
17900000
17900000
17900000
17900000
17900000
17900000
17800000
17700000
17500000
17400000
17300000
17200000
17100000
17000000
16900000
16900000
16900000
16900000
16700000
16700000
16600000
16500000
16500000
16400000
16400000
16300000
16300000
16300000
16300000
16300000
16200000
16200000
16200000
16100000
16100000
16100000
15900000
15900000
15900000
15800000
15700000
15600000
15500000
15500000
15400000
15400000
15400000
15300000
15200000
15100000
15100000
15100000
15000000
15000000
15000000
15000000
15000000
14900000
14900000
14900000
14800000
14800000
14800000
14800000
14800000
14800000
14700000
14700000
14700000
14700000
14700000
14700000
14600000
14600000
14600000
14600000
14500000
14500000
14500000
14500000
14500000
14500000
14400000
14400000
14400000
14400000
14400000
14400000
14300000
14300000
14200000
14100000
14100000
14000000
13900000
13900000
13900000
13900000
13800000
13600000
13600000
13600000
13500000
13500000
13400000
13400000
13400000
13400000
13400000
13300000
13300000
13300000
13300000
13300000
13300000
13300000
13200000
13200000
13100000
13100000
13100000
13000000
13000000
12900000
12900000
12900000
12800000
12800000
12700000
12700000
12700000
12700000
12700000
12600000
12600000
12500000
12500000
12500000
12500000
12400000
12400000
12400000
12400000
12400000
12400000
Binary file Global YouTube Statistics.csv matches
bash-4.4$ cat Worksheet4/Subscribers/United_States.txt[1P.txt[1P.txt[1P.txt[1P.txt[1P.txt[1P.txt[1P.txt[1P.txt[1P.txt[1P.txt[1P.txt[1P.txt[1P.txtI.txtn.txtd.txti.txta.txt
245000000
159000000
96700000
83000000
70500000
65900000
65600000
64600000
61000000
59300000
58000000
57600000
57200000
54600000
53300000
47400000
46600000
45500000
42500000
41400000
39200000
38300000
38200000
37200000
37000000
36600000
35500000
35500000
35400000
34300000
34000000
33500000
33500000
33400000
32700000
32000000
31700000
31700000
30700000
30500000
29800000
28900000
28500000
28400000
28300000
28200000
27300000
27100000
26400000
26300000
25200000
24300000
24200000
23400000
23100000
23100000
23000000
23000000
22900000
22600000
22600000
22500000
21800000
21600000
21400000
21300000
21300000
21300000
20900000
20400000
20400000
20200000
20000000
19500000
19400000
19400000
19300000
19200000
19100000
19000000
18800000
18600000
17800000
17700000
17500000
17500000
17500000
17300000
17300000
17000000
16900000
16900000
16600000
16600000
16600000
16500000
16300000
16000000
15800000
15800000
15700000
15700000
15700000
15700000
15700000
15500000
15500000
15400000
15300000
15300000
15200000
15200000
15200000
15200000
15200000
15200000
15000000
15000000
15000000
15000000
15000000
14700000
14700000
14600000
14500000
14500000
14500000
14400000
14400000
14400000
14400000
14200000
14200000
14200000
14100000
14000000
14000000
13900000
13800000
13800000
13700000
13700000
13700000
13700000
13700000
13600000
13500000
13500000
13500000
13400000
13400000
13400000
13300000
13300000
13200000
13200000
13200000
13100000
13000000
12800000
12800000
12700000
12500000
12500000
12500000
12500000
12500000
12500000
12500000
12400000
12400000
12400000
12400000
12300000
12300000

bash-4.4$ vi greetings.txt
[?2004h[?1049h[22;0;0t[?1h=[?2004h[1;63r[?12h[?12l[27m[23m[29m[m[H[2J[?25l[63;1H"greetings.txt" [New File][2;1H[94m~                                                                                              [3;1H~                                                                                              [4;1H~                                                                                              [5;1H~                                                                                              [6;1H~                                                                                              [7;1H~                                                                                              [8;1H~                                                                                              [9;1H~                                                                                              [10;1H~                                                                                              [11;1H~                                                                                              [12;1H~                                                                                              [13;1H~                                                                                              [14;1H~                                                                                              [15;1H~                                                                                              [16;1H~                                                                                              [17;1H~                                                                                              [18;1H~                                                                                              [19;1H~                                                                                              [20;1H~                                                                                              [21;1H~                                                                                              [22;1H~                                                                                              [23;1H~                                                                                              [24;1H~                                                                                              [25;1H~                                                                                              [26;1H~                                                                                              [27;1H~                                                                                              [28;1H~                                                                                              [29;1H~                                                                                              [30;1H~                                                                                              [31;1H~                                                                                              [32;1H~                                                                                              [33;1H~                                                                                              [34;1H~                                                                                              [35;1H~                                                                                              [36;1H~                                                                                              [37;1H~                                                                                              [38;1H~                                                                                              [39;1H~                                                                                              [40;1H~                                                                                              [41;1H~                                                                                              [42;1H~                                                                                              [43;1H~                                                                                              [44;1H~                                                                                              [45;1H~                                                                                              [46;1H~                                                                                              [47;1H~                                                                                              [48;1H~                                                                                              [49;1H~                                                                                              [50;1H~                                                                                              [51;1H~                                                                                              [52;1H~                                                                                              [53;1H~                                                                                              [54;1H~                                                                                              [55;1H~                                                                                              [56;1H~                                                                                              [57;1H~                                                                                              [58;1H~                                                                                              [59;1H~                                                                                              [60;1H~                                                                                              [61;1H~                                                                                              [62;1H~                                                                                              [1;1H[?25h[?25l[m[63;1H[1m-- INSERT --[m[63;13H[K[1;1HHello, John Doe!
Hi, Jane Doe![2;14H[K[3;1HGreetings, John Smith![3;23H[K[4;1HHello, Mic[4;11H[K[4;11H[?25h[?25l[63;1H[K[4;11Hhael Johnson!
Hi, Emily Davis![5;17H[K[5;16H[?25h[?25l[63;1H:[?2004h[?25hwq
[?25l[?2004l"greetings.txt" [New] 5L, 95C written


[?2004l[?1l>[?25h[?1049l[23;0;0tbash-4.4$ sed -i 's/Hello/Hi/g' greetings.txt
bash-4.4$ cat greetings.txt 
Hi, John Doe!
Hi, Jane Doe!
Greetings, John Smith!
Hi, Michael Johnson!
Hi, Emily Davis!
bash-4.4$ sed -i '/Doe/d' greetings.txt
bash-4.4$ cat greetings.txt 
Greetings, John Smith!
Hi, Michael Johnson!
Hi, Emily Davis!
bash-4.4$ sed -i 's/$/ (edited)/' greetings.txt
bash-4.4$ cat greetings.txt 
Greetings, John Smith! (edited)
Hi, Michael Johnson! (edited)
Hi, Emily Davis! (edited)
bash-4.4$ sed -i '/^Hello,.*Michael Johnson/s/Michael Johnson/Mike Johnson/' greetings.txt
bash-4.4$ cat greetings.txt 
Greetings, John Smith! (edited)
Hi, Michael Johnson! (edited)
Hi, Emily Davis! (edited)
bash-4.4$ ls -1
Assignment1.txt
Assignment2.txt
cmds.log
counts.txt
cs131
file.txt
'Global YouTube Statistics.csv'
'Global YouTube Statistics.csv.1'
greetings.txt
index.html
months.txt
mydir
mymyPipe1
myPipe1
Scriptfilename
Scriptfilename.sh
sorted_counts.txt
temp_us_mean.txt
top_3_combinations.txt
typescript
United_states
users.lst
us_mean.txt
Worksheet2
Worksheet4
ws4.txt
year_month.txt
years.txt
bash-4.4$ cd cs131
bash-4.4$ cd Worksheet4
bash: cd: Worksheet4: No such file or directory
bash-4.4$ mkdir Worksheet4
bash-4.4$ cd ..
bash-4.4$ cd .
bash-4.4$ 
bash-4.4$ cd..
bash: cd..: command not found
bash-4.4$ ls -1
Assignment1.txt
Assignment2.txt
cmds.log
counts.txt
cs131
file.txt
'Global YouTube Statistics.csv'
'Global YouTube Statistics.csv.1'
greetings.txt
index.html
months.txt
mydir
mymyPipe1
myPipe1
Scriptfilename
Scriptfilename.sh
sorted_counts.txt
temp_us_mean.txt
top_3_combinations.txt
typescript
United_states
users.lst
us_mean.txt
Worksheet2
Worksheet4
ws4.txt
year_month.txt
years.txt
bash-4.4$ ca[K[Kcd Worksheet4
bash-4.4$ ls -l
total 4
drwxrwxr-x 2 gursimransp24 gursimransp24 4096 Apr  9 00:07 Subscribers
-rw-rw-r-- 1 gursimransp24 gursimransp24    0 Apr  9 00:04 ws4_means.txt
bash-4.4$ cd Subscribers/
bash-4.4$ ls -l
total 8
-rw-rw-r-- 1 gursimransp24 gursimransp24 1577 Apr  8 23:58 India.txt
-rw-rw-r-- 1 gursimransp24 gursimransp24 2762 Apr  8 23:58 United_States.txt
-rw-rw-r-- 1 gursimransp24 gursimransp24    0 Apr  9 00:16 US_mean.txt
bash-4.4$ rm /\[K[KUS_mean.txt 
bash-4.4$ ls -l
total 8
-rw-rw-r-- 1 gursimransp24 gursimransp24 1577 Apr  8 23:58 India.txt
-rw-rw-r-- 1 gursimransp24 gursimransp24 2762 Apr  8 23:58 United_States.txt
bash-4.4$ cd ..
bash-4.4$ pwd
/mnt/scratch/SP24_CS131_Jyotika/gursimransp24/Worksheet4
bash-4.4$ cd [K..
bash: cd..: command not found
bash-4.4$ cd ..
bash-4.4$ pwd
/mnt/scratch/SP24_CS131_Jyotika/gursimransp24
bash-4.4$ mv[K[Kmv greetings.txt Worksheet4/
bash-4.4$ cd Worksheet4
bash-4.4$ ls -l
total 8
-rw-rw-r-- 1 gursimransp24 gursimransp24   88 Apr  9 00:22 greetings.txt
drwxrwxr-x 2 gursimransp24 gursimransp24 4096 Apr  9 00:29 Subscribers
-rw-rw-r-- 1 gursimransp24 gursimransp24    0 Apr  9 00:04 ws4_means.txt
bash-4.4$ 
bash-4.4$ 
bash-4.4$ total_us=$(paste -sd+ Worksheet4/Subscribers/United_States.txt)
paste: Worksheet4/Subscribers/United_States.txt: No such file or directory
bash-4.4$ cd ..
bash-4.4$ total_us=$(paste -sd+ Worksheet4/Subscribers/United_States.txt)
bash-4.4$ count_us=$(wc -l < Worksheet4/Subscribers/United_States.txt)
bash-4.4$ echo "scale=2; $total_us / $count_us" | bc -lq > Worksheet4/ws4_means.txt
(standard_in) 1: syntax error
bash-4.4$ echo "$total_us / $count_us" | awk '{ printf "%.2f\n", $1 }' > Worksheet4/ws4_means.tx
xt
bash-4.4$ cat ws4.txt [K[K[K[K[K[K4_means.txt
cat: ws4_means.txt: No such file or directory
bash-4.4$ cd Worksheet4
bash-4.4$ cd Worksheet4at ws4_means.txt
170000000.00
bash-4.4$ cat ws4_means.txt
4Pd Worksheet4at ws4_means.txt
echo "$total_us / $count_us" | awk '{ printf "%.2f\n", $1 }' > Worksheet4/ws4_means.tx
xt[A[C[C[C[C[C[C[C[C[C[C[C[C[C[C[12Pscale=2; $total_us / $count_us" | bc -lq > Worksheet4/ws4_means.txt

[C[C[C[C[C[C[C[C[C[C[13Pcount_us=$(wc -l < Worksheet4/Subscribers/United_States.txt)
[C[C[C[C[C[C[C[C[C[C[3@total_us=$(paste -sd+[C[1P.txt)[1P.txt)[1P.txt)[1P.txt)[1P.txt)[1P.txt)[1P.txt)[1P.txt)[1P.txt)[1P.txt)[1P.txt)[1P.txt)[1P.txt)I.txt)n.txt)d.txt)i.txt)a.txt)
paste: Worksheet4/Subscribers/India.txt: No such file or directory
bash-4.4$ cd ..
bash-4.4$ cd ..total_India=$(paste -sd+ Worksheet4/Subscribers/India.txt)
bash-4.4$ total_India=$(paste -sd+ Worksheet4/Subscribers/India.txt)
cd ..[Ktotal_India=$(paste -sd+ Worksheet4/Subscribers/India.txt)
cat ws4_means.txt[K
[4Pd Worksheet4at ws4_means.txt
echo "$total_us / $count_us" | awk '{ printf "%.2f\n", $1 }' > Worksheet4/ws4_means.tx
xt[12Pscale=2; $total_us / $count_us" | bc -lq > Worksheet4/ws4_means.txt

bash-4.4$ count_india=$(wc -l < Worksheet4/Subscribers/India.txt)
bash-4.4$ echo "$total_india / $count_india" | awk '{ printf "%.2f\n", $1 }' >> Worksheet4/ws4_m
means.txt
bash-4.4$ 
bash-4.4$ 
bash-4.4$ cd Worksheet4
bash-4.4$ cat ws4_means.txt 
0.00
bash-4.4$ total_us=$(paste -sd+ Worksheet4/Subscribers/United_States.txt)
paste: Worksheet4/Subscribers/United_States.txt: No such file or directory
bash-4.4$ cd ..
bash-4.4$ total_us=$(paste -sd+ Worksheet4/Subscribers/United_States.txt)
bash-4.4$ count_us=$(wc -l < Worksheet4/Subscribers/United_States.txt)
bash-4.4$ echo "$total_us / $count_us" | awk '{ printf "%.2f\n", $1 }' > Worksheet4/ws4_means.tx
xt
bash-4.4$ echo "$total_us / $count_us" | awk '{ printf "%.2f\n", $1 }' > Worksheet4/ws4_means.tx
xt25Pcount_us=$(wc -l < Worksheet4/Subscribers/United_States.txt)


[3@total_us=$(paste -sd+[1@d[1@i[1@a
bash-4.4$ total_india=$(paste -sd+ Worksheet4/Subscribers/United_States.txt)
[Cecho "$total_us / $count_us" | awk '{ printf "%.2f\n", $1 }' > Worksheet4/ws4_means.tx
xt[Acount_us=$(wc -l < Worksheet4/Subscribers/United_States.txt)

Ctotal_india=$(paste -sd+ Worksheet4/Subscribers/United_States.txt)c -l < W
Worksheet4/Subscribers/United_States.txt)-l < Wo[1Prksheet4/Subscribers/United_States.txt) -l < Wor[1Pksheet4/Subscribers/United_States.txt)Work[1Psheet4/Subscribers/United_States.txt)Works[1Pheet4/Subscribers/United_States.txt)[A[CWorksh[1Peet4/Subscribers/United_States.txt)[A[C[C[C[C[C[C[C[C[C[C[C[C[C[C[C[C[C[C[C[C[C[C[C[C[C[C[C[C[C[C[C[C[C[C[C[C[C[C[C[C[C[C[C[C[C[C[Cc -l < Workshe[C[1Pt4/Subscribers/United_States.txt)[A[C[C[C[C[C[C[C[C[C[C[C[C[C[C[C[C[C[C[C[C[C[C[C[C[C[C[C[C[C[C[C[C[C[C[C[C[C[C[C[C[C[C[C[C[C[C[Cc -l < Workshee[1Pt4/Subscribers/United_States.txt)[A[C[C[C[C[C[C[C[C[C[C[C[C[C[C[C[C[C[C[C[C[C[C[C[C[C[C[C[C[C[C[C[C[C[C[C[C[C[C[C[C[C[C[C[C[C[C[Cc -l < Worksheet[1P4/Subscribers/United_States.txt)[A[C[C[C[C[C[C[C[C[C[C[C[C[C[C[C[C[C[C[C[C[C[C[C[C[C[C[C[C[C[C[C[C[C[C[C[C[C[C[C[C[C[C[C[C[C[C[Cc -l < Worksheet4[1P/Subscribers/United_States.txt)[A[C[C[C[C[C[C[C[C[C[C[C[C[C[C[C[C[C[C[C[C[C[C[C[C[C[C[C[C[C[C[C[C[C[C[C[C[C[C[C[C[C[C[C[C[C[C[Cc -l < Worksheet4/[1PSubscribers/United_States.txt)[A[C[C[C[C[C[C[C[C[C[C[C[C[C[C[C[C[C[C[C[C[C[C[C[C[C[C[C[C[C[C[C[C[C[C[C[C[C[C[C[C[C[C[C[C[C[C[Cc -l < Worksheet4/S[1Pubscribers/United_States.txt)[A[C[C[C[C[C[C[C[C[C[C[C[C[C[C[C[C[C[C[C[C[C[C[C[C[C[C[C[C[C[C[C[C[C[C[C[C[C[C[C[C[C[C[C[C[C[C[Cc -l < Worksheet4/Su[1Pbscribers/United_States.txt)[A[C[C[C[C[C[C[C[C[C[C[C[C[C[C[C[C[C[C[C[C[C[C[C[C[C[C[C[C[C[C[C[C[C[C[C[C[C[C[C[C[C[C[C[C[C[C[Cc -l < Worksheet4/Sub[1Pscribers/United_States.txt)[A[C[C[C[C[C[C[C[C[C[C[C[C[C[C[C[C[C[C[C[C[C[C[C[C[C[C[C[C[C[C[C[C[C[C[C[C[C[C[C[C[C[C[C[C[C[C[Cc -l < Worksheet4/Subs[1Pcribers/United_States.txt)[A[C[C[C[C[C[C[C[C[C[C[C[C[C[C[C[C[C[C[C[C[C[C[C[C[C[C[C[C[C[C[C[C[C[C[C[C[C[C[C[C[C[C[C[C[C[C[Cc -l < Worksheet4/Subsc[1Pribers/United_States.txt)[A[C[C[C[C[C[C[C[C[C[C[C[C[C[C[C[C[C[C[C[C[C[C[C[C[C[C[C[C[C[C[C[C[C[C[C[C[C[C[C[C[C[C[C[C[C[C[Cc -l < Worksheet4/Subscr[1Pibers/United_States.txt)[A[C[C[C[C[C[C[C[C[C[C[C[C[C[C[C[C[C[C[C[C[C[C[C[C[C[C[C[C[C[C[C[C[C[C[C[C[C[C[C[C[C[C[C[C[C[C[Cc -l < Worksheet4/Subscri[1Pbers/United_States.txt)[A[C[C[C[C[C[C[C[C[C[C[C[C[C[C[C[C[C[C[C[C[C[C[C[C[C[C[C[C[C[C[C[C[C[C[C[C[C[C[C[C[C[C[C[C[C[C[Cc -l < Worksheet4/Subscrib[1Pers/United_States.txt)[A[C[C[C[C[C[C[C[C[C[C[C[C[C[C[C[C[C[C[C[C[C[C[C[C[C[C[C[C[C[C[C[C[C[C[C[C[C[C[C[C[C[C[C[C[C[C[Cc -l < Worksheet4/Subscribe[1Prs/United_States.txt)[A[C[C[C[C[C[C[C[C[C[C[C[C[C[C[C[C[C[C[C[C[C[C[C[C[C[C[C[C[C[C[C[C[C[C[C[C[C[C[C[C[C[C[C[C[C[C[Cc -l < Worksheet4/Subscriber[1Ps/United_States.txt)[A[C[C[C[C[C[C[C[C[C[C[C[C[C[C[C[C[C[C[C[C[C[C[C[C[C[C[C[C[C[C[C[C[C[C[C[C[C[C[C[C[C[C[C[C[C[C[Cc -l < Worksheet4/Subscribers[1P/United_States.txt)[A[C[C[C[C[C[C[C[C[C[C[C[C[C[C[C[C[C[C[C[C[C[C[C[C[C[C[C[C[C[C[C[C[C[C[C[C[C[C[C[C[C[C[C[C[C[C[Cc -l < Worksheet4/Subscribers/[1PUnited_States.txt)[A[C[C[C[C[C[C[C[C[C[C[C[C[C[C[C[C[C[C[C[C[C[C[C[C[C[C[C[C[C[C[C[C[C[C[C[C[C[C[C[C[C[C[C[C[C[C[Cc -l < Worksheet4/Subscribers/U[1Pnited_States.txt)[A[C[C[C[C[C[C[C[C[C[C[C[C[C[C[C[C[C[C[C[C[C[C[C[C[C[C[C[C[C[C[C[C[C[C[C[C[C[C[C[C[C[C[C[C[C[C[Cc -l < Worksheet4/Subscribers/Un[1Pited_States.txt)[A[C[C[C[C[C[C[C[C[C[C[C[C[C[C[C[C[C[C[C[C[C[C[C[C[C[C[C[C[C[C[C[C[C[C[C[C[C[C[C[C[C[C[C[C[C[C[Cc -l < Worksheet4/Subscribers/Uni[1Pted_States.txt)[A[C[C[C[C[C[C[C[C[C[C[C[C[C[C[C[C[C[C[C[C[C[C[C[C[C[C[C[C[C[C[C[C[C[C[C[C[C[C[C[C[C[C[C[C[C[C[C -l < Worksheet4/Subscribers/Unit[1Ped_States.txt)[A[C[C[C[C[C[C[C[C[C[C[C[C[C[C[C[C[C[C[C[C[C[C[C[C[C[C[C[C[C[C[C[C[C[C[C[C[C[C[C[C[C[C[C[C[C[C[Cc -l < Worksheet4/Subscribers/Unite[1Pd_States.txt)[A[C[C[C[C[C[C[C[C[C[C[C[C[C[C[C[C[C[C[C[C[C[C[C[C[C[C[C[C[C[C[C[C[C[C[C[C[C[C[C[C[C[C[C[C[C[C[Cc -l < Worksheet4/Subscribers/United[1P_States.txt)[A[C[C[C[C[C[C[C[C[C[C[C[C[C[C[C[C[C[C[C[C[C[C[C[C[C[C[C[C[C[C[C[C[C[C[C[C[C[C[C[C[C[C[C[C[C[C[Cc -l < Worksheet4/Subscribers/United_[1PStates.txt)[A[C[C[C[C[C[C[C[C[C[C[C[C[C[C[C[C[C[C[C[C[C[C[C[C[C[C[C[C[C[C[C[C[C[C[C[C[C[C[C[C[C[C[C[C[C[C[Cc -l < Worksheet4/Subscribers/United_S[1Ptates.txt)[A[C[C[C[C[C[C[C[C[C[C[C[C[C[C[C[C[C[C[C[C[C[C[C[C[C[C[C[C[C[C[C[C[C[C[C[C[C[C[C[C[C[C[C[C[C[C[C
[C[C[C[C[C[C[C[C[C[C[22Ptotal_us=$(paste -sd+ Worksheet4/Subscribers/United_States.txt)


cd ..[Ktotal_us=$(paste -sd+ Worksheet4/Subscribers/United_States.txt)
cat ws4_means.txt [K
[5Pd Worksheet4at ws4_means.txt 
total_us=$(paste -sd+ Worksheet4/Subscribers/United_States.txt)
cd ..[Ktotal_us=$(paste -sd+ Worksheet4/Subscribers/United_States.txt)
[Ccount_us=$(wtotal_india=$(paste -sd+ Worksheet4/c -l < Worksheet4/Subscribers/United_S
States.txt)[Aecho "$total_us / $count_us" | awk '{ printf "%.2f\n", $1 }' > Worksheet4/ws4_means.tx[C[K[A[C[C[C[C[C[C[C[C[19Ptotal_india=$(paste -sd+ Worksheet4/Subscribers/United_States.txt)

[K[A[C[C[C[C[C[C[C[C[C[C[C[C[C[C[C[C[C[C[C[C[C[C[C[C[C[C[C[C[C[C[C[C[C[C[C[C[C[C[C[C[C[C[C[C[C[C[C[C[C[C[C[C[C[C[C[C[C[C[C[C[C[C[C[C[C[C[C[C[C[C[C[C[C[C[C[C
[C[C[C[C[C[C[C[C[C[C[Ktotal_india=$(paste -sd+ Worksheet4/Subscribers/United_States.txt)[C[1P.txt)[1P.txt)[1P.txt)[1P.txt)[1P.txt)[1P.txt)[1P.txt)[1P.txt)[1P.txt)[1P.txt)[1P.txt)[1P.txt)[1P.txt)I.txt)n.txt)d.txt)i.txt)a.txt)
bash-4.4$ total_india=$(paste -sd+ Worksheet4/Subscribers/India.txt)United_States.txt)
[C[C[C[C[C[C[C[C[C[Cecho "$total_us / $count_us" | awk '{ printf "%.2f\n", $1 }' > Worksheet4/ws4_means.tx
xt[A[C[C[C[C[C[C[C[Ccount_us=$(wtotal_india=$(paste -sd+ Worksheet4/c -l < Worksheet4/Subscribers/United_S[Cates.txt)[A[22Ptotal_us=$(paste -sd+ Worksheet4/Subscribers/United_States.txt)
count_us=$(wtotal_india=$(paste -sd+ Worksheet4/c -l < Worksheet4/Subscribers/United_S
States.txt)
=$(wtotal_india=$(paste -sd+ Worksheet4/c -l < Worksheet4/Subscribers/United_St[1Pates.txt)[A[C[C[C[C[C[C[C=$(wtotal_india=$(paste -sd+ Worksheet4/c -l < Worksheet4/Subscribers/United_Sta[1Ptes.txt)[A[C[C[C[C[C[C[Ci=$(wtotal_india=$(paste -sd+ Worksheet4/c -l < Worksheet4/Subscribers/United_States.txt)[A[C[C[C[C[C[C[Cn=$(wtotal_india=$(paste -sd+ Worksheet4/c -l < Worksheet4/Subscribers/United_States.txt)[A[C[C[C[C[C[C[Cd=$(wtotal_india=$(paste -sd+ Worksheet4/c -l < Worksheet4/Subscribers/United_States.txt)[A[C[C[C[C[C[C[Ci=$(wtotal_india=$(paste -sd+ Worksheet4/c -l < Worksheet4/Subscribers/United_States.txt)[A[C[C[C[C[C[C[Ca=$(wtotal_india=$(paste -sd+ Worksheet4/c -l < Worksheet4/Subscribers/United_States.txt)[A[C[C[C[C[C[C[C[C[C[C[C[C[C[C[C[C[C[C[C[C[C[C[C[C[C[C[C[C[C[C[C[C[C[C[C[C[C[

[C[C[C[C[C[C[C[C[C[C[C\.txt)\.txt)\\\\.txt)[1P.txt)[1P.txt)[1P.txt)[1P.txt)[1P.txt)[1P.txt)[1P.txt)[1P.txt)[1P.txt)[1P.txt)[1P.txt)[1P.txt)
[C[C[C[1P.txt)
[C[C[1P.txt)
[C
[1P.txt)
count_india=$(wc -l < Worksheet4/Subscribers/India.txt)
bash-4.4$ echo "$total_india / $count_india" | awk '{ printf "%.2f\n", $1 }' >> Worksheet4/ws4_m
means.txt
bash-4.4$ cd Worksheet4
bash-4.4$ cat ws4_means.txt 
170000000.00
245000000.00
bash-4.4$ ls -l
total 12
-rw-rw-r-- 1 gursimransp24 gursimransp24   88 Apr  9 00:22 greetings.txt
drwxrwxr-x 2 gursimransp24 gursimransp24 4096 Apr  9 00:29 Subscribers
-rw-rw-r-- 1 gursimransp24 gursimransp24   26 Apr  9 00:42 ws4_means.txt
bash-4.4$ 
[Kbash-4.4$ 
[Kbash-4.4$ 
[Kbash-4.4$ exit

Script done on 2024-04-09 00:43:20-04:00
